.5231524253333343
4....T^..^T..^.^.
1T^........T.T.T.
5...T^.^.^T^.^.T.
1......T.....T.^.
5.^TT^..^T^T^.T..
1..T.....TT...^..
6^T^...^.^T^....^
1...T^.TT.T..T.TT
5..^T...^.^..^.^.
2^T...^T.........
4T......T^.^T.^.^
3^..^T.^TT....T.T
3..T.....^..^T^TT
4^T^.^T.........^
3....T.^.T^.^....
3^T..^.T....T..^T