.603132231205
5^.^.^.T^...^
.T.T.T......T
2....^T....T^
4^T^T...^T^..
1.....^TT....
3^T...TT^...^
2T.T^.^.....T
3^.T.....T^T^
2T.^.T.^.....
2^...^.T.T..T
3T.....^T^..^
1^...........