.36271634434526164436
6...^TT^.^.^T....^TT^
2T^......T..T^.......
4.T..T^.TT^...T^.^TT.
5.^.^...^..T^......^.
2...T.........^T^....
6.^T^.^.^T^.....T..^.
1...T.T.T....^T....TT
7^TT^.T^...^T...^T^.^
2.....T.T^...T^...T..
5.^T^T^.....^T.T^.T.T
3.....T.T..T.T^.T.^.^
5..^T.^.^..^....^....
4^T...........^T..^T^
5...^T.T^.^T^..T^.T..
4.^..T^..T..TT^..T..^
4.T.^T...^T^.....^..T
4^....^.....TT^....^T
3TT^..T.....^....^..T
3.T...T^.^T.T....T..^
5.^.T^......^..T^T^..