.322042232413
1..T.T^......
4^.^....^.^..
1T....^.T.T..
2.^...T..T^..
1.T.T^.......
4..^...T^.^T^
1^.T.T.T.T.TT
4T...^.^.^.^.
1T^..T......T
4....^.^T^..^
0T......TTT..
5^..T^..^.^T^
