.13121211
3T^.^..T^
1.T.T.^..
1.^...T..
.T.......
3^.^.^T..
1..T...^.
1.T.^TTT.
2.^...^..