.5243416043241516
5^T.^.T^..^TT.^TT
2...T....T..^.T.^
4...^.^..^....^..
2T^.T.T........T^
3T..T^....T.^T^..
4^.^T.T^..^.T....
2..T.^T........T^
4..^...TT^T^.^T.T
3^.....^........^
0T..T............
5T^.^.....^.^..^.
1..T.T.^TTT.T..T.
5..^.^...^.^...T^
3^TT..T^...T..^..
3T.^T^.TT^..T.T.T
5^.....^....^T^.^